8 8

0 0 0 0 0 0 0 0
0 1 3 2 4 1 2 0
0 3 3 1 2 4 1 0
0 4 2 3 1 2 1 0
0 2 1 4 3 4 2 0
0 1 3 1 2 3 4 0
0 3 2 2 1 4 3 0
0 0 0 0 0 0 0 0